1
5 5
6
x m b m x
e e e e e
x e r e x
e e e e e
x m e m x
1 0
1 4
2 1
3 0
3 2
3 4