1
5 5
5
e m e e e
e e e m b
e e e e e
r e e e m
x e e e x
0 3
2 1
2 3
4 1
4 2