1
5 5
4
e e e e e
e e m e e
r e e e b
e e m e e
e e e e e
0 4
0 3
4 0
4 3