1
5 5
5
e e e e e
e e m e e
e m e m e
e e m e e
b e e e e
0 2
2 0
2 2
2 4
4 2